CREATE (HuevosRevueltos: Comida {nombre: 'Huevos Revueltos', ingredientes:['huevo','sal','pimienta'], tipo: 'Desayuno', recomendaciones: []}) CREATE (Omelette: Comida {nombre: 'Omelette', ingredientes: ['huevo', 'sal', 'pimienta','queso'], tipo: 'Desayuno', recomendaciones: []}) CREATE (Avena: Comida {nombre: 'Avena', ingredientes: ['avena','leche'], tipo: 'Desayuno', recomendaciones: []}) CREATE (Desayuno: Tipo {nombre: 'Desayuno'} ) CREATE (Flan: Comida {nombre: 'Flan', ingredientes: ['huevo', 'azúcar','leche','leche condensada','extracto de vainilla'], tipo: 'Postre', recomendaciones: []}) CREATE (Postre: Tipo{ nombre: 'Postre'}) CREATE (Almuerzo: Tipo {nombre: 'Almuerzo'}) CREATE (Quesadilla: Comida {nombre: 'Quesadilla', ingredientes: ['tortilla de harina','queso'], tipo: 'Almuerzo', recomendaciones: []})
CREATE (Huevo: Ingrediente {nombre: 'huevo'}) CREATE (Batido: Comida {nombre: 'Batido', ingredientes:['leche','helado'], tipo: 'Bebidas', recomendaciones: []}) CREATE (Jugo de Naranja: Comida {nombre: 'Jugo de Naranja', ingredientes:['naranja','agua'], tipo: 'Bebidas', recomendaciones: []})CREATE (Bebidas: Tipo {nombre: 'Bebidas'} )

CREATE (Picante: Tipo {nombre: 'Picante'} )CREATE (Vegano: Tipo {nombre: 'Vegano'} )CREATE (Snacks: Tipo {nombre: 'Snacks'} )CREATE (Saludable: Tipo {nombre: 'Saludable'} ) CREATE (Coreano: Tipo {nombre: 'Coreano'} ) CREATE (ComidaRápida: Tipo {nombre: 'Comida Rápida'} )
CREATE (Sándwiches: Tipo {nombre: 'Sándwiches'} ) CREATE (Pastas: Tipo {nombre: 'Pastas'} ) CREATE (Sopas: Tipo {nombre: 'Sopas'} )
CREATE (Guatemalteca: Tipo {nombre: 'Guatemalteca'} ) CREATE (Japonesa: Tipo {nombre: 'Japonesa'} )CREATE (Mexicana: Tipo {nombre: 'Mexicana'} ) CREATE (Ensaladas: Tipo {nombre: 'Ensaladas'} )

CREATE (Queso: Ingrediente {nombre: 'queso'}) CREATE (Leche: Ingrediente {nombre: 'leche'}) CREATE (Frijol: Ingrediente {nombre: 'frijol'})CREATE (TortilladeHarina: Ingrediente {nombre: 'tortilla de harina'}) CREATE (Tomate: Ingrediente {nombre: 'tomate'}) CREATE (Pan: Ingrediente {nombre: 'pan'}) CREATE (Salchicha: Ingrediente {nombre: 'salchicha'}) CREATE (Aguacate: Ingrediente {nombre: 'aguacate'}) CREATE (Papa: Ingrediente {nombre: 'papa'}) CREATE (Lechuga: Ingrediente {nombre: 'lechuga'}) CREATE (Kimchi: Ingrediente {nombre: 'kimchi'}) CREATE (Tofu: Ingrediente {nombre: 'tofu'}) CREATE (Pollo: Ingrediente {nombre: 'pollo'})

CREATE (Tostadas: Comida {nombre: 'Tostadas', ingredientes: ['pan','mantequilla','mermelada'], tipo: 'Desayuno', recomendaciones: []})
CREATE (Croissant: Comida {nombre: 'Croissant', ingredientes: ['harina','mantequilla','azúcar'], tipo: 'Desayuno', recomendaciones: []})
CREATE (Panqueques: Comida {nombre: 'Panqueques', ingredientes: ['harina','leche','huevo'], tipo: 'Desayuno', recomendaciones: []})
CREATE (Waffles: Comida {nombre: 'Waffles', ingredientes: ['harina','leche','huevo'], tipo: 'Desayuno', recomendaciones: []})
CREATE (TortilladePapa: Comida {nombre: 'Tortilla de Papa', ingredientes: ['huevo','papa','cebolla'], tipo: 'Desayuno', recomendaciones: []})
CREATE (SandwichDesayuno: Comida {nombre: 'Sandwich de Desayuno', ingredientes: ['pan','huevo','jamón','queso'], tipo: 'Desayuno', recomendaciones: []})
CREATE (Bagel: Comida {nombre: 'Bagel', ingredientes: ['pan','queso crema','salmon'], tipo: 'Desayuno', recomendaciones: []})
CREATE (Granola: Comida {nombre: 'Granola', ingredientes: ['avena','miel','nueces'], tipo: 'Desayuno', recomendaciones: []})
CREATE (Smoothie: Comida {nombre: 'Smoothie', ingredientes: ['frutas','agua','miel'], tipo: 'Desayuno', recomendaciones: []})
CREATE (Muffin: Comida {nombre: 'Muffin', ingredientes: ['harina','azúcar','huevo'], tipo: 'Desayuno', recomendaciones: []})
CREATE (BowlDeFrutas: Comida {nombre: 'Bowl de Frutas', ingredientes: ['frutas','yogurt','granola'], tipo: 'Desayuno', recomendaciones: []})
CREATE (HuevosBenedictinos: Comida {nombre: 'Huevos Benedictinos', ingredientes: ['huevo','pan','jamón','salsa holandesa'], tipo: 'Desayuno', recomendaciones: []})
CREATE (HotCakes: Comida {nombre: 'Hot Cakes', ingredientes: ['harina','leche','huevo'], tipo: 'Desayuno', recomendaciones: []})
CREATE (Cereal: Comida {nombre: 'Cereal', ingredientes: ['cereal','leche','frutas'], tipo: 'Desayuno', recomendaciones: []})
CREATE (YogurtConGranola: Comida {nombre: 'Yogurt con Granola', ingredientes: ['yogurt','granola','miel'], tipo: 'Desayuno', recomendaciones: []})
CREATE (HuevosRevueltosTomate: Comida {nombre: 'Huevos Revueltos con Tomate', ingredientes: ['huevo','tomate','sal','pimienta'], tipo: 'Desayuno', recomendaciones: []})
CREATE (Chilaquiles: Comida {nombre: 'Chilaquiles', ingredientes: ['tortilla','salsa','queso','crema'], tipo: 'Desayuno', recomendaciones: []})
CREATE (HuevosMexicanos: Comida {nombre: 'Huevos Mexicanos', ingredientes: ['huevo','tomate','cebolla','chile'], tipo: 'Desayuno', recomendaciones: []})
CREATE (EnchiladasDesayuno: Comida {nombre: 'Enchiladas de Desayuno', ingredientes: ['tortilla','huevo','salsa','queso'], tipo: 'Desayuno', recomendaciones: []})
CREATE (BurritoDesayuno: Comida {nombre: 'Burrito de Desayuno', ingredientes: ['tortilla de harina','huevo','frijol','queso'], tipo: 'Desayuno', recomendaciones: []})
CREATE (HuevosRancheros: Comida {nombre: 'Huevos Rancheros', ingredientes: ['huevo','tortilla','salsa','frijol'], tipo: 'Desayuno', recomendaciones: []})
CREATE (PanTostadoconMieldeMaple: Comida {nombre: 'Pan Tostado con Miel de Maple', ingredientes: ['pan','miel de maple'], tipo: 'Desayuno', recomendaciones: []})

CREATE (EnsaladaCésar: Comida {nombre: 'Ensalada César', ingredientes:['lechuga','pollo','aderezo César'], tipo: 'Ensaladas', recomendaciones: []})
CREATE (EnsaladaCaprese: Comida {nombre: 'Ensalada Caprese', ingredientes:['tomate','queso','albahaca','aceite de oliva'], tipo: 'Ensaladas', recomendaciones: []})
CREATE (EnsaladaMixta: Comida {nombre: 'Ensalada Mixta', ingredientes:['lechuga','tomate','zanahoria','pepino'], tipo: 'Ensaladas', recomendaciones: []})
CREATE (EnsaladaDeFrutas: Comida {nombre: 'Ensalada de Frutas', ingredientes:['manzana','naranja','piña','fresas'], tipo: 'Ensaladas', recomendaciones: []})
CREATE (EnsaladaCobb: Comida {nombre: 'Ensalada Cobb', ingredientes:['pollo','aguacate','tocino','huevo'], tipo: 'Ensaladas', recomendaciones: []})
CREATE (EnsaladaColeslaw: Comida {nombre: 'Ensalada Coleslaw', ingredientes:['repollo','zanahoria','mayonesa','vinagre'], tipo: 'Ensaladas', recomendaciones: []})
CREATE (EnsaladaGreek: Comida {nombre: 'Ensalada Greek', ingredientes:['pepino','tomate','aceitunas','queso'], tipo: 'Ensaladas', recomendaciones: []})
CREATE (EnsaladaWaldorf: Comida {nombre: 'Ensalada Waldorf', ingredientes:['manzana','apio','nueces','mayonesa'], tipo: 'Ensaladas', recomendaciones: []})
CREATE (EnsaladaDeQuinoa: Comida {nombre: 'Ensalada de Quinoa', ingredientes:['quinoa','tomate','pepino','aguacate'], tipo: 'Ensaladas', recomendaciones: []})
CREATE (EnsaladaDeAtún: Comida {nombre: 'Ensalada de Atún', ingredientes:['atún','lechuga','tomate','cebolla'], tipo: 'Ensaladas', recomendaciones: []})
CREATE (EnsaladaNicoise: Comida {nombre: 'Ensalada Nicoise', ingredientes:['atún','papa','ejote','huevo'], tipo: 'Ensaladas', recomendaciones: []})
CREATE (EnsaladaDePollo: Comida {nombre: 'Ensalada de Pollo', ingredientes:['pollo','lechuga','tomate','zanahoria'], tipo: 'Ensaladas', recomendaciones: []})
CREATE (EnsaladaDeLentejas: Comida {nombre: 'Ensalada de Lentejas', ingredientes:['lentejas','cebolla','tomate','perejil'], tipo: 'Ensaladas', recomendaciones: []})
CREATE (EnsaladaDeCuscús: Comida {nombre: 'Ensalada de Cuscús', ingredientes:['cuscús','tomate','pepino','menta'], tipo: 'Ensaladas', recomendaciones: []})
CREATE (EnsaladaDeGarbanzos: Comida {nombre: 'Ensalada de Garbanzos', ingredientes:['garbanzos','tomate','cebolla','cilantro'], tipo: 'Ensaladas', recomendaciones: []})
CREATE (EnsaladaDeRemolacha: Comida {nombre: 'Ensalada de Remolacha', ingredientes:['remolacha','queso','nueces','rúcula'], tipo: 'Ensaladas', recomendaciones: []})
CREATE (EnsaladaDePapa: Comida {nombre: 'Ensalada de Papa', ingredientes:['papa','mayonesa','mostaza','cebolla'], tipo: 'Ensaladas', recomendaciones: []})
CREATE (EnsaladaDeEspárragos: Comida {nombre: 'Ensalada de Espárragos', ingredientes:['espárragos','tomate','limón'], tipo: 'Ensaladas', recomendaciones: []})
CREATE (EnsaladaDeArroz: Comida {nombre: 'Ensalada de Arroz', ingredientes:['arroz','maíz','pimiento','aceitunas'], tipo: 'Ensaladas', recomendaciones: []})
CREATE (EnsaladaDeZanahoria: Comida {nombre: 'Ensalada de Zanahoria', ingredientes:['zanahoria','naranja','pasas','cilantro'], tipo: 'Ensaladas', recomendaciones: []})
CREATE (EnsaladaDeCamarones: Comida {nombre: 'Ensalada de Camarones', ingredientes:['camarones','aguacate','tomate','cebolla'], tipo: 'Ensaladas', recomendaciones: []})
CREATE (EnsaladaDeRúcula: Comida {nombre: 'Ensalada de Rúcula', ingredientes:['rúcula','tomate','queso','nueces'], tipo: 'Ensaladas', recomendaciones: []})
CREATE (EnsaladaDePolloALaParrilla: Comida {nombre: 'Ensalada de Pollo a la Parrilla', ingredientes:['pollo','espinacas','arándanos','almendras'], tipo: 'Ensaladas', recomendaciones: []})
CREATE (EnsaladaDeHuevo: Comida {nombre: 'Ensalada de Huevo', ingredientes:['huevo','mayonesa','mostaza','cebolla'], tipo: 'Ensaladas', recomendaciones: []})
CREATE (EnsaladaDeTomate: Comida {nombre: 'Ensalada de Tomate', ingredientes:['tomate','cebolla','queso','albahaca'], tipo: 'Ensaladas', recomendaciones: []})

CREATE (Tacos: Comida {nombre: 'Tacos', ingredientes:['tortilla de maíz','carne','cebolla','cilantro'], tipo: 'Mexicana', recomendaciones: []})
CREATE (Enchiladas: Comida {nombre: 'Enchiladas', ingredientes:['tortilla de maíz','pollo','salsa','queso'], tipo: 'Mexicana', recomendaciones: []})
CREATE (ChilesRellenos: Comida {nombre: 'Chiles Rellenos', ingredientes:['chiles','queso','carne','salsa'], tipo: 'Mexicana', recomendaciones: []})
CREATE (Pozole: Comida {nombre: 'Pozole', ingredientes:['maíz','carne','chiles','cebolla'], tipo: 'Mexicana', recomendaciones: []})
CREATE (Tamales: Comida {nombre: 'Tamales', ingredientes:['masa de maíz','pollo','salsa','hoja de maíz'], tipo: 'Mexicana', recomendaciones: []})
CREATE (Ceviche: Comida {nombre: 'Ceviche', ingredientes:['pescado','limón','cebolla','cilantro'], tipo: 'Mexicana', recomendaciones: []})
CREATE (Tortas: Comida {nombre: 'Tortas', ingredientes:['pan','carne','aguacate','mayonesa'], tipo: 'Mexicana', recomendaciones: []})
CREATE (Sopes: Comida {nombre: 'Sopes', ingredientes:['masa de maíz','frijol','carne','salsa'], tipo: 'Mexicana', recomendaciones: []})
CREATE (ChilesEnNogada: Comida {nombre: 'Chiles en Nogada', ingredientes:['chiles','picadillo','nueces','perejil'], tipo: 'Mexicana', recomendaciones: []})
CREATE (Mole: Comida {nombre: 'Mole', ingredientes:['chiles','chocolate','almendras','pollo'], tipo: 'Mexicana', recomendaciones: []})
CREATE (Chalupas: Comida {nombre: 'Chalupas', ingredientes:['tortilla de maíz','carne','cebolla','salsa'], tipo: 'Mexicana', recomendaciones: []})
CREATE (QuesadillasMexicana: Comida {nombre: 'Quesadillas Mexicanas', ingredientes:['tortilla de maíz','queso','salsa','crema'], tipo: 'Mexicana', recomendaciones: []})
CREATE (Pambazos: Comida {nombre: 'Pambazos', ingredientes:['pan','papa','chorizo','salsa'], tipo: 'Mexicana', recomendaciones: []})
CREATE (CochinitaPibil: Comida {nombre: 'Cochinita Pibil', ingredientes:['cerdo','achiote','naranja','cebolla'], tipo: 'Mexicana', recomendaciones: []})
CREATE (TostadasMexicanas: Comida {nombre: 'Tostadas Mexicanas', ingredientes:['tortilla de maíz','frijol','pollo','lechuga'], tipo: 'Mexicana', recomendaciones: []})
CREATE (Gorditas: Comida {nombre: 'Gorditas', ingredientes:['masa de maíz','relleno de su elección','salsa','queso'], tipo: 'Mexicana', recomendaciones: []})
CREATE (Huaraches: Comida {nombre: 'Huaraches', ingredientes:['masa de maíz','frijol','carne','salsa'], tipo: 'Mexicana', recomendaciones: []})
CREATE (Tlacoyos: Comida {nombre: 'Tlacoyos', ingredientes:['masa de maíz','frijol','nopal','salsa'], tipo: 'Mexicana', recomendaciones: []})
CREATE (Pipián: Comida {nombre: 'Pipián', ingredientes:['calabaza','semillas de calabaza','chiles','pollo'], tipo: 'Mexicana', recomendaciones: []})
CREATE (SalsaRoja: Comida {nombre: 'Salsa Roja', ingredientes:['tomate','chiles','cebolla','ajo'], tipo: 'Mexicana', recomendaciones: []})
CREATE (SalsaVerde: Comida {nombre: 'Salsa Verde', ingredientes:['tomatillo','chiles','cebolla','cilantro'], tipo: 'Mexicana', recomendaciones: []})
CREATE (SalsaGuacamole: Comida {nombre: 'Salsa Guacamole', ingredientes:['aguacate','tomate','cebolla','limón'], tipo: 'Mexicana', recomendaciones: []})
CREATE (SalsaPicoDeGallo: Comida {nombre: 'Salsa Pico de Gallo', ingredientes:['tomate','cebolla','ajo','limón'], tipo: 'Mexicana', recomendaciones: []})

CREATE (Sushi: Comida {nombre: 'Sushi', ingredientes:['arroz','pescado','alga','wasabi'], tipo: 'Japonesa', recomendaciones: []})
CREATE (Ramen: Comida {nombre: 'Ramen', ingredientes:['fideos','caldo','carne','huevo'], tipo: 'Japonesa', recomendaciones: []})
CREATE (Tempura: Comida {nombre: 'Tempura', ingredientes:['verduras','mariscos','harina','salsa tempura'], tipo: 'Japonesa', recomendaciones: []})
CREATE (Gyoza: Comida {nombre: 'Gyoza', ingredientes:['masa de dumpling','carne','cebolla','ajo'], tipo: 'Japonesa', recomendaciones: []})
CREATE (Tonkatsu: Comida {nombre: 'Tonkatsu', ingredientes:['filete de cerdo empanizado','repollo','salsa tonkatsu'], tipo: 'Japonesa', recomendaciones: []})
CREATE (Okonomiyaki: Comida {nombre: 'Okonomiyaki', ingredientes:['repollo','carne','harina','salsa okonomiyaki'], tipo: 'Japonesa', recomendaciones: []})
CREATE (Yakitori: Comida {nombre: 'Yakitori', ingredientes:['brochetas de pollo','salsa tare','cebolla verde'], tipo: 'Japonesa', recomendaciones: []})
CREATE (Udon: Comida {nombre: 'Udon', ingredientes:['fideos','caldo dashi','tempura','cebolla verde'], tipo: 'Japonesa', recomendaciones: []})
CREATE (Sashimi: Comida {nombre: 'Sashimi', ingredientes:['pescado','salsa de soya','wasabi'], tipo: 'Japonesa', recomendaciones: []})
CREATE (Takoyaki: Comida {nombre: 'Takoyaki', ingredientes:['masa de harina','pulpo','salsa takoyaki','bonito'], tipo: 'Japonesa', recomendaciones: []})
CREATE (Yakisoba: Comida {nombre: 'Yakisoba', ingredientes:['fideos','carne','verduras','salsa yakisoba'], tipo: 'Japonesa', recomendaciones: []})
CREATE (Chawanmushi: Comida {nombre: 'Chawanmushi', ingredientes:['huevo','caldo dashi','setas','camarones'], tipo: 'Japonesa', recomendaciones: []})
CREATE (MisoSoup: Comida {nombre: 'Miso Soup', ingredientes:['pasta de miso','tofu','alga wakame','cebolla verde'], tipo: 'Japonesa', recomendaciones: []})
CREATE (Sukiyaki: Comida {nombre: 'Sukiyaki', ingredientes:['carne','verduras','tofu','salsa sukiyaki'], tipo: 'Japonesa', recomendaciones: []})
CREATE (Oyakodon: Comida {nombre: 'Oyakodon', ingredientes:['pollo','huevo','cebolla','salsa de soya'], tipo: 'Japonesa', recomendaciones: []})
CREATE (Unagi: Comida {nombre: 'Unagi', ingredientes:['anguila','salsa de anguila','arroz','alga'], tipo: 'Japonesa', recomendaciones: []})
CREATE (Yuba: Comida {nombre: 'Yuba', ingredientes:['tofu','salsa de soya','daikon','cebolla verde'], tipo: 'Japonesa', recomendaciones: []})
CREATE (Nikujaga: Comida {nombre: 'Nikujaga', ingredientes:['carne','papa','zanahorias','salsa de soya'], tipo: 'Japonesa', recomendaciones: []})
CREATE (Gomaae: Comida {nombre: 'Gomaae', ingredientes:['espinacas','salsa de sésamo','semillas de sésamo','tofu'], tipo: 'Japonesa', recomendaciones: []})
CREATE (KatsuCurry: Comida {nombre: 'Katsu Curry', ingredientes:['filete empanizado','arroz','curry','zanahorias'], tipo: 'Japonesa', recomendaciones: []})
CREATE (SobaNoodles: Comida {nombre: 'Soba Noodles', ingredientes:['fideos','caldo dashi','tempura','cebolla verde'], tipo: 'Japonesa', recomendaciones: []})
CREATE (Chirashizushi: Comida {nombre: 'Chirashizushi', ingredientes:['arroz','pescado','mariscos','vegetales'], tipo: 'Japonesa', recomendaciones: []})
CREATE (Dorayaki: Comida {nombre: 'Dorayaki', ingredientes:['panqueques','anko','miel','matcha'], tipo: 'Japonesa', recomendaciones: []})
CREATE (MatchaLatte: Comida {nombre: 'Matcha Latte', ingredientes:['matcha','leche','miel','agua'], tipo: 'Japonesa', recomendaciones: []})
CREATE (Karaage: Comida {nombre: 'Karaage', ingredientes:['pollo','salsa de soya','jengibre','ajo'], tipo: 'Japonesa', recomendaciones: []})


CREATE (SopaDeTomate: Comida {nombre: 'Sopa de Tomate', ingredientes:['tomate','cebolla','ajo','caldo de verduras'], tipo: 'Sopas', recomendaciones: []})
CREATE (SopaDeLentejas: Comida {nombre: 'Sopa de Lentejas', ingredientes:['lentejas','cebolla','zanahoria','apio'], tipo: 'Sopas', recomendaciones: []})
CREATE (SopaMinestrone: Comida {nombre: 'Sopa Minestrone', ingredientes:['zanahoria','apio','frijol','fideos'], tipo: 'Sopas', recomendaciones: []})
CREATE (SopaDePollo: Comida {nombre: 'Sopa de Pollo', ingredientes:['pollo','zanahoria','cebolla','caldo de pollo'], tipo: 'Sopas', recomendaciones: []})
CREATE (SopaDeVerduras: Comida {nombre: 'Sopa de Verduras', ingredientes:['zanahoria','calabacín','col','caldo de verduras'], tipo: 'Sopas', recomendaciones: []})
CREATE (SopaDePescado: Comida {nombre: 'Sopa de Pescado', ingredientes:['pescado','tomate','cebolla','caldo de pescado'], tipo: 'Sopas', recomendaciones: []})
CREATE (SopaDeFideos: Comida {nombre: 'Sopa de Fideos', ingredientes:['fideos','pollo','zanahoria','caldo de pollo'], tipo: 'Sopas', recomendaciones: []})
CREATE (SopaDeCalabaza: Comida {nombre: 'Sopa de Calabaza', ingredientes:['calabaza','cebolla','caldo de verduras','crema'], tipo: 'Sopas', recomendaciones: []})
CREATE (SopaDeGuisantes: Comida {nombre: 'Sopa de Guisantes', ingredientes:['guisantes','cebolla','caldo de verduras','menta'], tipo: 'Sopas', recomendaciones: []})
CREATE (SopaDeFrijolesNegros: Comida {nombre: 'Sopa de Frijoles Negros', ingredientes:['frijol','cebolla','pimiento','caldo de pollo'], tipo: 'Sopas', recomendaciones: []})
CREATE (SopaDePapa: Comida {nombre: 'Sopa de Papa', ingredientes:['papa','cebolla','caldo de pollo','queso'], tipo: 'Sopas', recomendaciones: []})
CREATE (SopaDeGarbanzos: Comida {nombre: 'Sopa de Garbanzos', ingredientes:['garbanzos','tomate','cebolla','caldo de verduras'], tipo: 'Sopas', recomendaciones: []})
CREATE (SopaDeColiflor: Comida {nombre: 'Sopa de Coliflor', ingredientes:['coliflor','cebolla','caldo de verduras','nuez moscada'], tipo: 'Sopas', recomendaciones: []})
CREATE (SopaDeHongos: Comida {nombre: 'Sopa de Hongos', ingredientes:['hongos','cebolla','caldo de champiñones','crema'], tipo: 'Sopas', recomendaciones: []})
CREATE (SopaDeZanahoria: Comida {nombre: 'Sopa de Zanahoria', ingredientes:['zanahoria','cebolla','caldo de verduras','jengibre'], tipo: 'Sopas', recomendaciones: []})
CREATE (SopaDeMaíz: Comida {nombre: 'Sopa de Maíz', ingredientes:['maíz','cebolla','caldo de verduras','crema'], tipo: 'Sopas', recomendaciones: []})
CREATE (SopaDeEspárragos: Comida {nombre: 'Sopa de Espárragos', ingredientes:['espárragos','cebolla','caldo de verduras','crema'], tipo: 'Sopas', recomendaciones: []})
CREATE (SopaDePolloConFideos: Comida {nombre: 'Sopa de Pollo con Fideos', ingredientes:['pollo','fideos','zanahoria','caldo de pollo'], tipo: 'Sopas', recomendaciones: []})
CREATE (SopaDeTomateYAlbóndigas: Comida {nombre: 'Sopa de Tomate y Albóndigas', ingredientes:['tomate','albóndigas','cebolla','caldo de pollo'], tipo: 'Sopas', recomendaciones: []})
CREATE (SopaDeTomateYArroz: Comida {nombre: 'Sopa de Tomate y Arroz', ingredientes:['tomate','arroz','cebolla','caldo de verduras'], tipo: 'Sopas', recomendaciones: []})
CREATE (SopaDePolloConVerduras: Comida {nombre: 'Sopa de Pollo con Verduras', ingredientes:['pollo','zanahoria','calabacín','caldo de pollo'], tipo: 'Sopas', recomendaciones: []})
CREATE (SopaDeCebollaGratinada: Comida {nombre: 'Sopa de Cebolla Gratinada', ingredientes:['cebolla','caldo de carne','queso','pan'], tipo: 'Sopas', recomendaciones: []})
CREATE (SopaDeFrijolesBlancos: Comida {nombre: 'Sopa de Frijoles Blancos', ingredientes:['frijol','cebolla','zanahoria','caldo de verduras'], tipo: 'Sopas', recomendaciones: []})
CREATE (SopaDeCalabacín: Comida {nombre: 'Sopa de Calabacín', ingredientes:['calabacín','cebolla','caldo de verduras','queso'], tipo: 'Sopas', recomendaciones: []})

CREATE (SpaghettiBolognese: Comida {nombre: 'Spaghetti Bolognese', ingredientes:['spaghetti','carne molida','salsa de tomate'], tipo: 'Pastas', recomendaciones: []})
CREATE (FettuccineAlfredo: Comida {nombre: 'Fettuccine Alfredo', ingredientes:['fettuccine','crema','queso parmesano'], tipo: 'Pastas', recomendaciones: []})
CREATE (Lasagna: Comida {nombre: 'Lasagna', ingredientes:['pasta de lasaña','carne molida','salsa bechamel','salsa de tomate'], tipo: 'Pastas', recomendaciones: []})
CREATE (Ravioli: Comida {nombre: 'Ravioli', ingredientes:['ravioli','relleno de carne o queso','salsa de tomate'], tipo: 'Pastas', recomendaciones: []})
CREATE (Tortellini: Comida {nombre: 'Tortellini', ingredientes:['tortellini','relleno de carne o queso','salsa de tomate'], tipo: 'Pastas', recomendaciones: []})
CREATE (PenneArrabiata: Comida {nombre: 'Penne Arrabiata', ingredientes:['penne','salsa picante de tomate'], tipo: 'Pastas', recomendaciones: []})
CREATE (Carbonara: Comida {nombre: 'Carbonara', ingredientes:['spaghetti','tocino','huevos','queso parmesano'], tipo: 'Pastas', recomendaciones: []})
CREATE (TagliatelleBoscaiola: Comida {nombre: 'Tagliatelle Boscaiola', ingredientes:['tagliatelle','hongos','tocino','crema'], tipo: 'Pastas', recomendaciones: []})
CREATE (PestoGenovese: Comida {nombre: 'Pesto Genovese', ingredientes:['pasta corta','salsa pesto','piñones','queso parmesano'], tipo: 'Pastas', recomendaciones: []})
CREATE (FarfallePrimavera: Comida {nombre: 'Farfalle Primavera', ingredientes:['farfalle','verduras','aceite de oliva'], tipo: 'Pastas', recomendaciones: []})
CREATE (LinguineFruttiDiMare: Comida {nombre: 'Linguine Frutti Di Mare', ingredientes:['linguine','mariscos','salsa de tomate'], tipo: 'Pastas', recomendaciones: []})
CREATE (PappardelleFunghi: Comida {nombre: 'Pappardelle Funghi', ingredientes:['pappardelle','hongos','crema'], tipo: 'Pastas', recomendaciones: []})
CREATE (TortelloniRicottaEsSpinaci: Comida {nombre: 'Tortelloni Ricotta e Spinaci', ingredientes:['tortelloni','relleno de ricotta y espinacas','salsa de tomate'], tipo: 'Pastas', recomendaciones: []})
CREATE (SpaghettiAglioEOlio: Comida {nombre: 'Spaghetti Aglio e Olio', ingredientes:['spaghetti','ajo','aceite de oliva','guindilla'], tipo: 'Pastas', recomendaciones: []})
CREATE (OrecchietteBroccoliESalsiccia: Comida {nombre: 'Orecchiette Broccoli e Salsiccia', ingredientes:['orecchiette','brócoli','salchicha','ajo'], tipo: 'Pastas', recomendaciones: []})
CREATE (RigatoniAmatriciana: Comida {nombre: 'Rigatoni Amatriciana', ingredientes:['rigatoni','tocino','salsa de tomate'], tipo: 'Pastas', recomendaciones: []})
CREATE (GnocchiGorgonzolaENoci: Comida {nombre: 'Gnocchi Gorgonzola e Noci', ingredientes:['gnocchi','salsa de gorgonzola','nueces'], tipo: 'Pastas', recomendaciones: []})
CREATE (CannelloniRicottaESpinaci: Comida {nombre: 'Cannelloni Ricotta e Spinaci', ingredientes:['cannelloni','relleno de ricotta y espinacas','salsa de tomate','salsa bechamel'], tipo: 'Pastas', recomendaciones: []})
CREATE (ConchiglieQuattroFormaggi: Comida {nombre: 'Conchiglie Quattro Formaggi', ingredientes:['conchiglie','salsa de cuatro quesos'], tipo: 'Pastas', recomendaciones: []})
CREATE (PaccheriAllaNorma: Comida {nombre: 'Paccheri alla Norma', ingredientes:['paccheri','berenjena','salsa de tomate','queso ricotta'], tipo: 'Pastas', recomendaciones: []})
CREATE (TrenettePestoESalmone: Comida {nombre: 'Trenette Pesto e Salmone', ingredientes:['trenette','salsa pesto','salmón'], tipo: 'Pastas', recomendaciones: []})
CREATE (FusilliArrabbiata: Comida {nombre: 'Fusilli Arrabbiata', ingredientes:['fusilli','salsa picante de tomate'], tipo: 'Pastas', recomendaciones: []})
CREATE (PaccheriRaguNapoletano: Comida {nombre: 'Paccheri Ragu Napoletano', ingredientes:['paccheri','salsa de carne napoletana'], tipo: 'Pastas', recomendaciones: []})
CREATE (TortelloniPannaENoci: Comida {nombre: 'Tortelloni Panna e Noci', ingredientes:['tortelloni','crema','nueces'], tipo: 'Pastas', recomendaciones: []})
CREATE (OrecchietteBroccoliEGamberetti: Comida {nombre: 'Orecchiette Broccoli e Gamberetti', ingredientes:['orecchiette','brócoli','camarones','ajo'], tipo: 'Pastas', recomendaciones: []})

CREATE (SándwichBLT: Comida {nombre: 'Sándwich BLT', ingredientes:['pan','tocino','lechuga','tomate'], tipo: 'Sándwiches', recomendaciones: []})
CREATE (SándwichClub: Comida {nombre: 'Sándwich Club', ingredientes:['pan','pollo','tocino','lechuga','tomate'], tipo: 'Sándwiches', recomendaciones: []})
CREATE (SándwichDeJamónyQueso: Comida {nombre: 'Sándwich de Jamón y Queso', ingredientes:['pan','jamón','queso'], tipo: 'Sándwiches', recomendaciones: []})
CREATE (SándwichDeAtún: Comida {nombre: 'Sándwich de Atún', ingredientes:['pan','atún','mayonesa','verduras'], tipo: 'Sándwiches', recomendaciones: []})
CREATE (SándwichVegetariano: Comida {nombre: 'Sándwich Vegetariano', ingredientes:['pan','queso','verduras'], tipo: 'Sándwiches', recomendaciones: []})
CREATE (SándwichDeCarneAsada: Comida {nombre: 'Sándwich de Carne Asada', ingredientes:['pan','carne','queso','verduras'], tipo: 'Sándwiches', recomendaciones: []})
CREATE (SándwichDeRoastBeef: Comida {nombre: 'Sándwich de Roast Beef', ingredientes:['pan','roast beef','queso','verduras'], tipo: 'Sándwiches', recomendaciones: []})
CREATE (SándwichDePolloALaParrilla: Comida {nombre: 'Sándwich de Pollo a la Parrilla', ingredientes:['pan','pollo','queso','verduras'], tipo: 'Sándwiches', recomendaciones: []})
CREATE (SándwichCubano: Comida {nombre: 'Sándwich Cubano', ingredientes:['pan','cerdo','jamón','queso','mostaza','pepinillos'], tipo: 'Sándwiches', recomendaciones: []})
CREATE (SándwichDePescado: Comida {nombre: 'Sándwich de Pescado', ingredientes:['pan','filete de pescado','lechuga','salsa tártara'], tipo: 'Sándwiches', recomendaciones: []})
CREATE (SándwichDeQuesoFundido: Comida {nombre: 'Sándwich de Queso Fundido', ingredientes:['pan','queso','jalapeños'], tipo: 'Sándwiches', recomendaciones: []})
CREATE (SándwichDePechugaDePavo: Comida {nombre: 'Sándwich de Pechuga de Pavo', ingredientes:['pan','pavo','queso','verduras'], tipo: 'Sándwiches', recomendaciones: []})
CREATE (SándwichDeAguacate: Comida {nombre: 'Sándwich de Aguacate', ingredientes:['pan','aguacate','queso','verduras'], tipo: 'Sándwiches', recomendaciones: []})
CREATE (SándwichDePolloTeriyaki: Comida {nombre: 'Sándwich de Pollo Teriyaki', ingredientes:['pan','pollo', 'teriyaki','queso','verduras'], tipo: 'Sándwiches', recomendaciones: []})
CREATE (SándwichDeCarneDeshebrada: Comida {nombre: 'Sándwich de Carne Deshebrada', ingredientes:['pan','carne','queso','verduras'], tipo: 'Sándwiches', recomendaciones: []})
CREATE (SándwichDeJamonSerrano: Comida {nombre: 'Sándwich de Jamón Serrano', ingredientes:['pan','jamón','queso'], tipo: 'Sándwiches', recomendaciones: []})
CREATE (SándwichDeTomateyQueso: Comida {nombre: 'Sándwich de Tomate y Queso', ingredientes:['pan','tomate','queso'], tipo: 'Sándwiches', recomendaciones: []})
CREATE (SándwichDePechugaDePollo: Comida {nombre: 'Sándwich de Pechuga de Pollo', ingredientes:['pan','pollo','queso','verduras'], tipo: 'Sándwiches', recomendaciones: []})
CREATE (SándwichDeCarneMolida: Comida {nombre: 'Sándwich de Carne Molida', ingredientes:['pan','carne','queso','verduras'], tipo: 'Sándwiches', recomendaciones: []})
CREATE (SándwichDePolloCrispy: Comida {nombre: 'Sándwich de Pollo Crispy', ingredientes:['pan','pollo','lechuga','mayonesa'], tipo: 'Sándwiches', recomendaciones: []})
CREATE (SándwichDeCarneEnSalsa: Comida {nombre: 'Sándwich de Carne en Salsa', ingredientes:['pan','carne en salsa','queso','verduras'], tipo: 'Sándwiches', recomendaciones: []})
CREATE (SándwichDeLomo: Comida {nombre: 'Sándwich de Lomo', ingredientes:['pan','lomo','queso','verduras'], tipo: 'Sándwiches', recomendaciones: []})
CREATE (SándwichDeQuesoALaParrilla: Comida {nombre: 'Sándwich de Queso a la Parrilla', ingredientes:['pan','queso'], tipo: 'Sándwiches', recomendaciones: []})
CREATE (SándwichDeQuesoALaParrillaconKimchi: Comida {nombre: 'Sándwich de Queso a la Parrilla con Kimchi', ingredientes:['pan','queso','kimchi','azúcar'], tipo: 'Sándwiches', recomendaciones: []})

CREATE (Hamburguesa: Comida {nombre: 'Hamburguesa', ingredientes:['pan','carne','queso'], tipo: 'Comida Rápida', recomendaciones: []})
CREATE (HamburguesadePollo: Comida {nombre: 'Hamburguesa de Pollo', ingredientes:['pan','pollo','queso'], tipo: 'Comida Rápida', recomendaciones: []})
CREATE (Pizza: Comida {nombre: 'Pizza', ingredientes:['masa','salsa de tomate','queso'], tipo: 'Comida Rápida', recomendaciones: []})
CREATE (Hotdog: Comida {nombre: 'Hotdog', ingredientes:['pan','salchicha','salsa'], tipo: 'Comida Rápida', recomendaciones: []})
CREATE (PapasFritas: Comida {nombre: 'Papas Fritas', ingredientes:['papas','aceite','sal'], tipo: 'Comida Rápida', recomendaciones: []})
CREATE (Empanadas: Comida {nombre: 'Empanadas', ingredientes:['masa','relleno','huevo'], tipo: 'Comida Rápida', recomendaciones: []})
CREATE (Burritos: Comida {nombre: 'Burritos', ingredientes:['tortilla de harina','carne','frijoles','queso'], tipo: 'Comida Rápida', recomendaciones: []})
CREATE (PolloFrito: Comida {nombre: 'Pollo Frito', ingredientes:['pollo','harina','especias'], tipo: 'Comida Rápida', recomendaciones: []})
CREATE (Wrap: Comida {nombre: 'Wrap', ingredientes:['tortilla de harina','pollo','verduras'], tipo: 'Comida Rápida', recomendaciones: []})
CREATE (FishAndChips: Comida {nombre: 'Fish and Chips', ingredientes:['pescado','papas fritas','salsa tártara'], tipo: 'Comida Rápida', recomendaciones: []})
CREATE (Kebab: Comida {nombre: 'Kebab', ingredientes:['pan de pita','carne','verduras'], tipo: 'Comida Rápida', recomendaciones: []})
CREATE (NuggetsDePollo: Comida {nombre: 'Nuggets de Pollo', ingredientes:['pollo','pan rallado','salsa'], tipo: 'Comida Rápida', recomendaciones: []})
CREATE (PitaPockets: Comida {nombre: 'Pita Pockets', ingredientes:['pan de pita','carne','verduras'], tipo: 'Comida Rápida', recomendaciones: []})
CREATE (Donas: Comida {nombre: 'Donas', ingredientes:['masa','azúcar','glaseado'], tipo: 'Comida Rápida', recomendaciones: []})
CREATE (Fajitas: Comida {nombre: 'Fajitas', ingredientes:['tortilla','carne','pimientos'], tipo: 'Comida Rápida', recomendaciones: []})
CREATE (Crepe: Comida {nombre: 'Crepe', ingredientes:['harina','huevos','relleno'], tipo: 'Comida Rápida', recomendaciones: []})
CREATE (Bocadillos: Comida {nombre: 'Bocadillos', ingredientes:['pan','carne','queso'], tipo: 'Comida Rápida', recomendaciones: []})
CREATE (CornDog: Comida {nombre: 'Corn Dog', ingredientes:['salchicha','maíz','harina','huevo'], tipo: 'Comida Rápida', recomendaciones: []})
CREATE (KoreanCornDog: Comida {nombre: 'Korean Corn Dog', ingredientes:['salchicha','panko','queso','azúcar'], tipo: 'Comida Rápida', recomendaciones: []})
CREATE (ArosDeCebolla: Comida {nombre: 'Aros de Cebolla', ingredientes:['cebolla','harina','huevo','pimentón'], tipo: 'Comida Rápida', recomendaciones: []})
CREATE (ChickenTenders: Comida {nombre: 'Chicken Tenders', ingredientes:['pollo','harina','huevo','pan rallado'], tipo: 'Comida Rápida', recomendaciones: []})
CREATE (Alitas: Comida {nombre: 'Alitas', ingredientes:['pollo','salsa picante','mantequilla','cebolla en polvo'], tipo: 'Comida Rápida', recomendaciones: []})

CREATE (Bibimbap: Comida {nombre: 'Bibimbap', ingredientes:['arroz','vegetales','carne','huevo'], tipo: 'Coreano', recomendaciones: []})
CREATE (KimchiJjigae: Comida {nombre: 'Kimchi Jjigae', ingredientes:['kimchi','tofu'], tipo: 'Coreano', recomendaciones: []})
CREATE (Bulgogi: Comida {nombre: 'Bulgogi', ingredientes:['carne','salsa de soya','azúcar'], tipo: 'Coreano', recomendaciones: []})
CREATE (Samgyeopsal: Comida {nombre: 'Samgyeopsal', ingredientes:['cerdo','lechuga','salsa ssam'], tipo: 'Coreano', recomendaciones: []})
CREATE (Japchae: Comida {nombre: 'Japchae', ingredientes:['fideos','vegetales','carne'], tipo: 'Coreano', recomendaciones: []})
CREATE (Galbijjim: Comida {nombre: 'Galbijjim', ingredientes:['costillas de res','salsa de soya','azúcar'], tipo: 'Coreano', recomendaciones: []})
CREATE (Tteokbokki: Comida {nombre: 'Tteokbokki', ingredientes:['tteok','salsa de gochujang','azúcar'], tipo: 'Coreano', recomendaciones: []})
CREATE (Jjajangmyeon: Comida {nombre: 'Jjajangmyeon', ingredientes:['fideos','salsa de jjajang','carne'], tipo: 'Coreano', recomendaciones: []})
CREATE (BibimNaengmyeon: Comida {nombre: 'Bibim Naengmyeon', ingredientes:['fideos','salsa picante','vegetales'], tipo: 'Coreano', recomendaciones: []})
CREATE (HaemulPajeon: Comida {nombre: 'Haemul Pajeon', ingredientes:['mariscos','cebolla','pimienta'], tipo: 'Coreano', recomendaciones: []})
CREATE (DakGalbi: Comida {nombre: 'Dak Galbi', ingredientes:['pollo','salsa de gochujang','vegetales'], tipo: 'Coreano', recomendaciones: []})
CREATE (Bingsu: Comida {nombre: 'Bingsu', ingredientes:['hielo','frutas','leche condensada'], tipo: 'Coreano', recomendaciones: []})
CREATE (Jajangbap: Comida {nombre: 'Jajangbap', ingredientes:['arroz','salsa de jjajang','carne'], tipo: 'Coreano', recomendaciones: []})
CREATE (Kimbap: Comida {nombre: 'Kimbap', ingredientes:['arroz','vegetales','carne'], tipo: 'Coreano', recomendaciones: []})
CREATE (BulgogiDePollo: Comida {nombre: 'Bulgogi de Pollo', ingredientes:['pollo','salsa de soya','azúcar'], tipo: 'Coreano', recomendaciones: []})
CREATE (Yukgaejang: Comida {nombre: 'Yukgaejang', ingredientes:['carne','vegetales','guindilla'], tipo: 'Coreano', recomendaciones: []})
CREATE (DwaejiGalbi: Comida {nombre: 'Dwaeji Galbi', ingredientes:['costillas de cerdo','salsa de soya','azúcar'], tipo: 'Coreano', recomendaciones: []})
CREATE (Mandu: Comida {nombre: 'Mandu', ingredientes:['masa de harina','carne','verduras'], tipo: 'Coreano', recomendaciones: []})
CREATE (SundubuJjigae: Comida {nombre: 'Sundubu Jjigae', ingredientes:['tofu','mariscos','salsa de soya'], tipo: 'Coreano', recomendaciones: []})
CREATE (Jjamppong: Comida {nombre: 'Jjamppong', ingredientes:['fideos','mariscos','salsa picante'], tipo: 'Coreano', recomendaciones: []})
CREATE (Naengmyeon: Comida {nombre: 'Naengmyeon', ingredientes:['fideos','caldo frío','carne'], tipo: 'Coreano', recomendaciones: []})
CREATE (Kkanpunggi: Comida {nombre: 'Kkanpunggi', ingredientes:['pollo','salsa picante','vegetales'], tipo: 'Coreano', recomendaciones: []})
CREATE (Gamjatang: Comida {nombre: 'Gamjatang', ingredientes:['costillas de cerdo','papa','vegetales'], tipo: 'Coreano', recomendaciones: []})
CREATE (BibimbapDePollo: Comida {nombre: 'Bibimbap de Pollo', ingredientes:['arroz','vegetales','pollo'], tipo: 'Coreano', recomendaciones: []})
CREATE (Buchimgae: Comida {nombre: 'Buchimgae', ingredientes:['masa de harina','mariscos','vegetales'], tipo: 'Coreano', recomendaciones: []})
CREATE (HobakJuk: Comida {nombre: 'Hobak Juk', ingredientes:['calabaza','arroz','azúcar'], tipo: 'Coreano', recomendaciones: []})
CREATE (kongGukSu: Comida {nombre: 'KongGukSu', ingredientes:['tofu','leche','mantequilla de maní'], tipo: 'Coreano', recomendaciones: []})
CREATE (BowlDeAcai: Comida {nombre: 'Bowl de Acai', ingredientes:['acai','frutas','granola'], tipo: 'Saludable', recomendaciones: []})
CREATE (WrapDePollo: Comida {nombre: 'Wrap de Pollo', ingredientes:['pollo','verduras','tortilla integral'], tipo: 'Saludable', recomendaciones: []})
CREATE (SalmónAlHorno: Comida {nombre: 'Salmón al Horno', ingredientes:['salmón','limón','especias'], tipo: 'Saludable', recomendaciones: []})
CREATE (BowlDeQuinoa: Comida {nombre: 'Bowl de Quinoa', ingredientes:['quinoa','vegetales','huevo'], tipo: 'Saludable', recomendaciones: []})
CREATE (TacosDePescado: Comida {nombre: 'Tacos de Pescado', ingredientes:['pescado','tortillas de maíz','salsa'], tipo: 'Saludable', recomendaciones: []})
CREATE (BowlDeCuscús: Comida {nombre: 'Bowl de Cuscús', ingredientes:['cuscús','vegetales','aderezo'], tipo: 'Saludable', recomendaciones: []})
CREATE (BowlDeSalmón: Comida {nombre: 'Bowl de Salmón', ingredientes:['salmón','arroz integral','vegetales'], tipo: 'Saludable', recomendaciones: []})
CREATE (PokeBowlSaludable: Comida {nombre: 'Poke Bowl Saludable', ingredientes:['arroz integral','pescado','vegetales'], tipo: 'Saludable', recomendaciones: []})
CREATE (WrapDeAtún: Comida {nombre: 'Wrap de Atún', ingredientes:['atún','vegetales','tortilla integral'], tipo: 'Saludable', recomendaciones: []})
CREATE (BowlDeAvena: Comida {nombre: 'Bowl de Avena', ingredientes:['avena','frutas','frutos secos'], tipo: 'Saludable', recomendaciones: []})
CREATE (TacosVegetarianos: Comida {nombre: 'Tacos Vegetarianos', ingredientes:['vegetales','tortillas de maíz','salsa'], tipo: 'Saludable', recomendaciones: []})
CREATE (BowlDeEspinacas: Comida {nombre: 'Bowl de Espinacas', ingredientes:['espinacas','quinoa','huevo'], tipo: 'Saludable', recomendaciones: []})
CREATE (EnsaladaDePavo: Comida {nombre: 'Ensalada de Pavo', ingredientes:['pavo','verduras','aderezo'], tipo: 'Saludable', recomendaciones: []})
CREATE (BatidoVerde: Comida {nombre: 'Batido Verde', ingredientes:['espinacas','plátano','jugo de naranja'], tipo: 'Saludable', recomendaciones: []})
CREATE (BowlDeCebada: Comida {nombre: 'Bowl de Cebada', ingredientes:['cebada','vegetales','queso'], tipo: 'Saludable', recomendaciones: []})
CREATE (BowlDeVegetales: Comida {nombre: 'Bowl de Vegetales', ingredientes:['vegetales','arroz integral','salsa'], tipo: 'Saludable', recomendaciones: []})

CREATE (PalomitasDeMaiz: Comida {nombre: 'Palomitas de Maíz', ingredientes:['maíz','mantequilla','sal'], tipo: 'Snacks', recomendaciones: []})
CREATE (ChipsDeTortilla: Comida {nombre: 'Chips de Tortilla', ingredientes:['tortillas de maíz','aceite','sal'], tipo: 'Snacks', recomendaciones: []})
CREATE (NachosConQueso: Comida {nombre: 'Nachos con Queso', ingredientes:['nachos','queso','jalapeños'], tipo: 'Snacks', recomendaciones: []})
CREATE (DipDeAguacate: Comida {nombre: 'Dip de Aguacate', ingredientes:['aguacate','limón','cilantro'], tipo: 'Snacks', recomendaciones: []})
CREATE (PalitosDeZanahoria: Comida {nombre: 'Palitos de Zanahoria', ingredientes:['zanahoria'], tipo: 'Snacks', recomendaciones: []})
CREATE (FrutosSecos: Comida {nombre: 'Frutos Secos', ingredientes:['almendras','nueces','cacahuetes'], tipo: 'Snacks', recomendaciones: []})
CREATE (RollitosDePrimavera: Comida {nombre: 'Rollitos de Primavera', ingredientes:['pasta de arroz','vegetales','salsa agridulce'], tipo: 'Snacks', recomendaciones: []})
CREATE (Churros: Comida {nombre: 'Churros', ingredientes:['harina','azúcar','aceite'], tipo: 'Snacks', recomendaciones: []})
CREATE (PopcornCaramelizado: Comida {nombre: 'Popcorn Caramelizado', ingredientes:['maíz','azúcar','mantequilla'], tipo: 'Snacks', recomendaciones: []})
CREATE (TostadasDeMaiz: Comida {nombre: 'Tostadas de Maíz', ingredientes:['tostadas','frijol','aguacate'], tipo: 'Snacks', recomendaciones: []})
CREATE (SalsaDeQueso: Comida {nombre: 'Salsa de Queso', ingredientes:['queso','salsa picante','chips'], tipo: 'Snacks', recomendaciones: []})
CREATE (RollitosDeQueso: Comida {nombre: 'Rollitos de Queso', ingredientes:['queso','jamón','pan'], tipo: 'Snacks', recomendaciones: []})
CREATE (DipDeEspinacas: Comida {nombre: 'Dip de Espinacas', ingredientes:['espinacas','queso crema','ajo'], tipo: 'Snacks', recomendaciones: []})
CREATE (BarritasDeCereal: Comida {nombre: 'Barritas de Cereal', ingredientes:['cereales','frutos secos','miel'], tipo: 'Snacks', recomendaciones: []})
CREATE (DeditosDeQueso: Comida {nombre: 'Deditos de Queso', ingredientes:['queso','pan rallado','huevo'], tipo: 'Snacks', recomendaciones: []})
CREATE (PanDeAjo: Comida {nombre: 'Pan de Ajo', ingredientes:['pan','ajo','mantequilla'], tipo: 'Snacks', recomendaciones: []})
CREATE (NachosConGuacamole: Comida {nombre: 'Nachos con Guacamole', ingredientes:['nachos','aguacate','tomate'], tipo: 'Snacks', recomendaciones: []})
CREATE (BolitasDeArroz: Comida {nombre: 'Bolitas de Arroz', ingredientes:['arroz','queso','pan rallado'], tipo: 'Snacks', recomendaciones: []})
CREATE (AceitunasRellenas: Comida {nombre: 'Aceitunas Rellenas', ingredientes:['aceitunas','queso','anchoas'], tipo: 'Snacks', recomendaciones: []})

CREATE (TofuRevuelto: Comida {nombre: 'Tofu Revuelto', ingredientes:['tofu','vegetales','salsa de soja'], tipo: 'Vegano', recomendaciones: []})
CREATE (WrapVegetariano: Comida {nombre: 'Wrap Vegetariano', ingredientes:['tortilla de trigo','vegetales','aguacate'], tipo: 'Vegano', recomendaciones: []})
CREATE (LentejasEstofadas: Comida {nombre: 'Lentejas Estofadas', ingredientes:['lentejas','cebolla','zanahoria','tomate'], tipo: 'Vegano', recomendaciones: []})
CREATE (CurryDeVegetales: Comida {nombre: 'Curry de Vegetales', ingredientes:['vegetales','leche de coco','curry en polvo'], tipo: 'Vegano', recomendaciones: []})
CREATE (Falafel: Comida {nombre: 'Falafel', ingredientes:['garbanzos','cebolla','ajo','especias'], tipo: 'Vegano', recomendaciones: []})
CREATE (BurgerDeLentejas: Comida {nombre: 'Burger de Lentejas', ingredientes:['lentejas','cebolla','zanahoria','pan integral'], tipo: 'Vegano', recomendaciones: []})
CREATE (PizzaVegetariana: Comida {nombre: 'Pizza Vegetariana', ingredientes:['masa de pizza','tomate','vegetales','queso vegano'], tipo: 'Vegano', recomendaciones: []})
CREATE (TacosDeVegetales: Comida {nombre: 'Tacos de Vegetales', ingredientes:['tortillas','vegetales','salsa picante'], tipo: 'Vegano', recomendaciones: []})
CREATE (SushiVegetariano: Comida {nombre: 'Sushi Vegetariano', ingredientes:['arroz','algas','vegetales'], tipo: 'Vegano', recomendaciones: []})
CREATE (PastaConSalsaDeTomate: Comida {nombre: 'Pasta con Salsa de Tomate', ingredientes:['pasta','tomate','cebolla','ajo'], tipo: 'Vegano', recomendaciones: []})
CREATE (EnchiladasDeVegetales: Comida {nombre: 'Enchiladas de Vegetales', ingredientes:['tortillas','vegetales','salsa de tomate'], tipo: 'Vegano', recomendaciones: []})
CREATE (BurritosVegetarianos: Comida {nombre: 'Burritos Vegetarianos', ingredientes:['tortillas','vegetales','frijol','aguacate'], tipo: 'Vegano', recomendaciones: []})
CREATE (Tabulé: Comida {nombre: 'Tabulé', ingredientes:['cuscús','tomate','pepino','menta'], tipo: 'Vegano', recomendaciones: []})
CREATE (ChiliVegetariano: Comida {nombre: 'Chili Vegetariano', ingredientes:['frijol','vegetales','tomate','especias'], tipo: 'Vegano', recomendaciones: []})
CREATE (ArrozConVegetales: Comida {nombre: 'Arroz con Vegetales', ingredientes:['arroz','vegetales','salsa de soya'], tipo: 'Vegano', recomendaciones: []})
CREATE (PokeBowlVegano: Comida {nombre: 'Poke Bowl Vegano', ingredientes:['arroz','vegetales','aguacate','salsa de soya'], tipo: 'Vegano', recomendaciones: []})
CREATE (CremaDeZanahoria: Comida {nombre: 'Crema de Zanahoria', ingredientes:['zanahoria','cebolla','caldo vegetal'], tipo: 'Vegano', recomendaciones: []})
CREATE (RollitosDeVerano: Comida {nombre: 'Rollitos de Verano', ingredientes:['arroz','vegetales','salsa de maní'], tipo: 'Vegano', recomendaciones: []})

CREATE (TacosPicantes: Comida {nombre: 'Tacos Picantes', ingredientes:['carne','cebolla','cilantro','salsa picante'], tipo: 'Picante', recomendaciones: []})
CREATE (CurryPicante: Comida {nombre: 'Curry Picante', ingredientes:['carne','vegetales','especias picantes'], tipo: 'Picante', recomendaciones: []})
CREATE (SalsaDeChile: Comida {nombre: 'Salsa de Chile', ingredientes:['chiles','tomate','cebolla','limón'], tipo: 'Picante', recomendaciones: []})
CREATE (CamaronesPicantes: Comida {nombre: 'Camarones Picantes', ingredientes:['camarones','chiles','ajo','salsa picante'], tipo: 'Picante', recomendaciones: []})
CREATE (PozolePicante: Comida {nombre: 'Pozole Picante', ingredientes:['maíz','cerdo','chiles','cebolla','limón'], tipo: 'Picante', recomendaciones: []})
CREATE (SalsaBuffalo: Comida {nombre: 'Salsa Buffalo', ingredientes:['salsa picante','mantequilla','ajo'], tipo: 'Picante', recomendaciones: []})
CREATE (HuevosRancherosPicantes: Comida {nombre: 'Huevos Rancheros Picantes', ingredientes:['huevo','salsa picante','tortillas','frijoles'], tipo: 'Picante', recomendaciones: []})
CREATE (ChiliConCarne: Comida {nombre: 'Chili con Carne', ingredientes:['carne','frijoles','tomate','chiles'], tipo: 'Picante', recomendaciones: []})
CREATE (SalsaDeHabanero: Comida {nombre: 'Salsa de Habanero', ingredientes:['chiles habaneros','tomate','cebolla','limón'], tipo: 'Picante', recomendaciones: []})
CREATE (BurritosPicantes: Comida {nombre: 'Burritos Picantes', ingredientes:['tortillas','carne','frijol','salsa picante'], tipo: 'Picante', recomendaciones: []})
CREATE (CevichePicante: Comida {nombre: 'Ceviche Picante', ingredientes:['pescado','limón','cebolla','chiles'], tipo: 'Picante', recomendaciones: []})
CREATE (SalsaDiablo: Comida {nombre: 'Salsa Diablo', ingredientes:['salsa picante','tomate','cebolla','chiles'], tipo: 'Picante', recomendaciones: []})
CREATE (SopaDeTortillaPicante: Comida {nombre: 'Sopa de Tortilla Picante', ingredientes:['tortillas','pollo','chiles','queso'], tipo: 'Picante', recomendaciones: []})
CREATE (AlitasPicantes: Comida {nombre: 'Alitas Picantes', ingredientes:['pollo','salsa picante','mantequilla'], tipo: 'Picante', recomendaciones: []})
CREATE (SalsaChimichurri: Comida {nombre: 'Salsa Chimichurri', ingredientes:['perejil','ajo','aceite','vinagre','chiles'], tipo: 'Picante', recomendaciones: []})
CREATE (TamalesPicantes: Comida {nombre: 'Tamales Picantes', ingredientes:['masa de maíz','pollo','salsa picante'], tipo: 'Picante', recomendaciones: []})
CREATE (SalsaSriracha: Comida {nombre: 'Salsa Sriracha', ingredientes:['chiles','ajo','vinagre','azúcar'], tipo: 'Picante', recomendaciones: []})
CREATE (CamaronesAlAjillo: Comida {nombre: 'Camarones al Ajillo', ingredientes:['camarones','ajo','aceite','chiles'], tipo: 'Picante', recomendaciones: []})
CREATE (SalsaPicante: Comida {nombre: 'Salsa Picante', ingredientes:['chiles','ajo','cebolla','tomate'], tipo: 'Picante', recomendaciones: []})
CREATE (SalsaMachaNorteña: Comida {nombre: 'Salsa Macha Norteña', ingredientes:['chiles','ajo','aceite','nueces'], tipo: 'Picante', recomendaciones: []})
CREATE (HuevosAhogados: Comida {nombre: 'Huevos Ahogados', ingredientes:['huevo','salsa picante','tortillas'], tipo: 'Picante', recomendaciones: []})

CREATE (Café: Comida {nombre: 'Café', ingredientes:['café','agua'], tipo: 'Bebidas', recomendaciones: []})
CREATE (Té: Comida {nombre: 'Té', ingredientes:['té','agua'], tipo: 'Bebidas', recomendaciones: []})
CREATE (Refresco: Comida {nombre: 'Refresco', ingredientes:['agua','azúcar','saborizante'], tipo: 'Bebidas', recomendaciones: []})
CREATE (Agua: Comida {nombre: 'Agua', ingredientes:['agua'], tipo: 'Bebidas', recomendaciones: []})
CREATE (Smoothie: Comida {nombre: 'Smoothie', ingredientes:['frutas','yogur','hielo'], tipo: 'Bebidas', recomendaciones: []})
CREATE (Margarita: Comida {nombre: 'Margarita', ingredientes:['tequila','limón','azúcar','hielo'], tipo: 'Bebidas', recomendaciones: []})
CREATE (PiñaColada: Comida {nombre: 'Piña Colada', ingredientes:['piña','ron','crema de coco','hielo'], tipo: 'Bebidas', recomendaciones: []})
CREATE (Mojito: Comida {nombre: 'Mojito', ingredientes:['ron','menta','limón','azúcar','hielo'], tipo: 'Bebidas', recomendaciones: []})
CREATE (AguaDeCoco: Comida {nombre: 'Agua de Coco', ingredientes:['coco','agua'], tipo: 'Bebidas', recomendaciones: []})
CREATE (Cerveza: Comida {nombre: 'Cerveza', ingredientes:['malta','lúpulo','levadura','agua'], tipo: 'Bebidas', recomendaciones: []})
CREATE (VinoTinto: Comida {nombre: 'Vino Tinto', ingredientes:['uvas','levadura'], tipo: 'Bebidas', recomendaciones: []})
CREATE (VinoBlanco: Comida {nombre: 'Vino Blanco', ingredientes:['uvas','levadura'], tipo: 'Bebidas', recomendaciones: []})
CREATE (Whisky: Comida {nombre: 'Whisky', ingredientes:['granos de cereal','agua'], tipo: 'Bebidas', recomendaciones: []})
CREATE (GinTonic: Comida {nombre: 'Gin Tonic', ingredientes:['ginebra','tónica','limón','hielo'], tipo: 'Bebidas', recomendaciones: []})
CREATE (Limonada: Comida {nombre: 'Limonada', ingredientes:['limón','agua','azúcar'], tipo: 'Bebidas', recomendaciones: []})
CREATE (Mate: Comida {nombre: 'Mate', ingredientes:['yerba mate','agua caliente'], tipo: 'Bebidas', recomendaciones: []})
CREATE (Sangría: Comida {nombre: 'Sangría', ingredientes:['vino tinto','frutas','azúcar','hielo'], tipo: 'Bebidas', recomendaciones: []})
CREATE (Mimosa: Comida {nombre: 'Mimosa', ingredientes:['champán','jugo de naranja'], tipo: 'Bebidas', recomendaciones: []})
CREATE (AguaMineral: Comida {nombre: 'Agua Mineral', ingredientes:['agua'], tipo: 'Bebidas', recomendaciones: []})
CREATE (MentaFresca: Comida {nombre: 'Menta Fresca', ingredientes:['menta','agua','azúcar'], tipo: 'Bebidas', recomendaciones: []})
CREATE (ZumoDeFrutas: Comida {nombre: 'Zumo de Frutas', ingredientes:['frutas','agua','azúcar'], tipo: 'Bebidas', recomendaciones: []})
CREATE (Lassi: Comida {nombre: 'Lassi', ingredientes:['yogurt','frutas','azúcar'], tipo: 'Bebidas', recomendaciones: []})
CREATE (Energizante: Comida {nombre: 'Energizante', ingredientes:['café','azúcar','taurina'], tipo: 'Bebidas', recomendaciones: []})
CREATE (VacaNegra: Comida {nombre: 'Vaca Negra', ingredientes:['helado','coca cola'], tipo: 'Bebidas', recomendaciones: []})

CREATE (PastelDeChocolate: Comida {nombre: 'Pastel de Chocolate', ingredientes: ['harina','azúcar','chocolate','mantequilla','huevos'], tipo: 'Postre', recomendaciones: []})
CREATE (Helado: Comida {nombre: 'Helado', ingredientes: ['leche','azúcar','vainilla'], tipo: 'Postre', recomendaciones: []})
CREATE (TartaDeManzana: Comida {nombre: 'Tarta de Manzana', ingredientes: ['masa','manzanas','azúcar','canela'], tipo: 'Postre', recomendaciones: []})
CREATE (Cheesecake: Comida {nombre: 'Cheesecake', ingredientes: ['galletas','queso crema','azúcar','huevos'], tipo: 'Postre', recomendaciones: []})
CREATE (MousseDeChocolate: Comida {nombre: 'Mousse de Chocolate', ingredientes: ['chocolate','nata','azúcar','huevos'], tipo: 'Postre', recomendaciones: []})
CREATE (Tiramisú: Comida {nombre: 'Tiramisú', ingredientes: ['bizcochos','café','queso mascarpone','cacao'], tipo: 'Postre', recomendaciones: []})
CREATE (Gelatina: Comida {nombre: 'Gelatina', ingredientes: ['gelatina','azúcar','agua'], tipo: 'Postre', recomendaciones: []})
CREATE (CremaCatalana: Comida {nombre: 'Crema Catalana', ingredientes: ['yemas de huevo','azúcar','leche','canela'], tipo: 'Postre', recomendaciones: []})
CREATE (Cupcakes: Comida {nombre: 'Cupcakes', ingredientes: ['harina','azúcar','mantequilla','huevos','leche'], tipo: 'Postre', recomendaciones: []})
CREATE (PannaCotta: Comida {nombre: 'Panna Cotta', ingredientes: ['nata','azúcar','gelatina','vainilla'], tipo: 'Postre', recomendaciones: []})
CREATE (MousseDeFrutas: Comida {nombre: 'Mousse de Frutas', ingredientes: ['frutas','nata','azúcar','gelatina'], tipo: 'Postre', recomendaciones: []})
CREATE (Buñuelos: Comida {nombre: 'Buñuelos', ingredientes: ['harina','levadura','azúcar','canela'], tipo: 'Postre', recomendaciones: []})
CREATE (TartaDeQueso: Comida {nombre: 'Tarta de Queso', ingredientes: ['galletas','queso crema','azúcar','huevos'], tipo: 'Postre', recomendaciones: []})
CREATE (Pudin: Comida {nombre: 'Pudin', ingredientes: ['pan','leche','azúcar','huevos'], tipo: 'Postre', recomendaciones: []})
CREATE (TrufasDeChocolate: Comida {nombre: 'Trufas de Chocolate', ingredientes: ['chocolate','nata','mantequilla','cacao en polvo'], tipo: 'Postre', recomendaciones: []})
CREATE (Brownies: Comida {nombre: 'Brownies', ingredientes: ['chocolate','mantequilla','azúcar','huevos','harina'], tipo: 'Postre', recomendaciones: []})
CREATE (Natillas: Comida {nombre: 'Natillas', ingredientes: ['leche','azúcar','yemas de huevo','vainilla'], tipo: 'Postre', recomendaciones: []})
CREATE (HeladoDeVainilla: Comida {nombre: 'Helado de Vainilla', ingredientes: ['leche','nata','azúcar','vainilla'], tipo: 'Postre', recomendaciones: []})
CREATE (CoulantDeChocolate: Comida {nombre: 'Coulant de Chocolate', ingredientes: ['chocolate','mantequilla','azúcar','huevos','harina'], tipo: 'Postre', recomendaciones: []})
CREATE (FrutasAsadas: Comida {nombre: 'Frutas Asadas', ingredientes: ['frutas','azúcar','canela'], tipo: 'Postre', recomendaciones: []})
CREATE (TartaDeFresas: Comida {nombre: 'Tarta de Fresas', ingredientes: ['masa','fresas','azúcar','gelatina'], tipo: 'Postre', recomendaciones: []})
CREATE (Mazapán: Comida {nombre: 'Mazapán', ingredientes: ['almendras','azúcar','huevo'], tipo: 'Postre', recomendaciones: []})

CREATE (ArrozFrito: Comida {nombre: 'Arroz Frito', ingredientes: ['arroz','verduras','huevo','salsa de soya'], tipo: 'Almuerzo', recomendaciones: []})
CREATE (QuesadilladePollo: Comida {nombre: 'Quesadilla de Pollo', ingredientes: ['tortilla de harina', 'queso','pollo'], tipo: 'Almuerzo', recomendaciones: []})

MATCH (c1:Comida), (c2:Comida) WHERE c1 <> c2 AND ANY(ingred IN c1.ingredientes WHERE ingred IN c2.ingredientes) CREATE (c1)-[:TIENE_INGREDIENTE_EN_COMUN]->(c2)
 
MATCH (t:Tipo), (c:Comida) WHERE c.tipo = t.nombre CREATE (t)-[:TIENE_COMIDA]->(c)  
	
MATCH (i:Ingrediente), (c:Comida) WHERE ANY(ingred IN c.ingredientes WHERE ingred = i.nombre) CREATE (i)-[:INGREDIENTE_DE]->(c)